ATL - HARTSFIELD-JACKSON ATLANTA INTERNATIONAL AIRPORT (ATLANTA, GEORGIA)
LAX - LOS ANGELES INTERNATIONAL AIRPORT (LOS ANGELES, CALIFORNIA)
ORD - O'HARE INTERNATIONAL AIRPORT (CHICAGO, ILLINOIS)
DFW - DALLAS/FORT WORTH INTERNATIONAL AIRPORT (DALLAS/FORT WORTH, TEXAS)
DEN - DENVER INTERNATIONAL AIRPORT (DENVER, COLORADO)
JFK - JOHN F. KENNEDY INTERNATIONAL AIRPORT (NEW YORK, NEW YORK)
SFO - SAN FRANCISCO INTERNATIONAL AIRPORT (SAN FRANCISCO, CALIFORNIA)
SEA - SEATTLE-TACOMA INTERNATIONAL AIRPORT (SEATTLE, WASHINGTON)
LAS - MCCARRAN INTERNATIONAL AIRPORT (LAS VEGAS, NEVADA)
MCO - ORLANDO INTERNATIONAL AIRPORT (ORLANDO, FLORIDA)
PHX - PHOENIX SKY HARBOR INTERNATIONAL AIRPORT (PHOENIX, ARIZONA)
MIA - MIAMI INTERNATIONAL AIRPORT (MIAMI, FLORIDA)
BOS - LOGAN INTERNATIONAL AIRPORT (BOSTON, MASSACHUSETTS)
IAH - GEORGE BUSH INTERCONTINENTAL AIRPORT (HOUSTON, TEXAS)
MSP - MINNEAPOLIS-SAINT PAUL INTERNATIONAL AIRPORT (MINNEAPOLIS, MINNESOTA)
DTW - DETROIT METROPOLITAN WAYNE COUNTY AIRPORT (DETROIT, MICHIGAN)
PHL - PHILADELPHIA INTERNATIONAL AIRPORT (PHILADELPHIA, PENNSYLVANIA)
CLT - CHARLOTTE DOUGLAS INTERNATIONAL AIRPORT (CHARLOTTE, NORTH CAROLINA)
LGA - LAGUARDIA AIRPORT (NEW YORK, NEW YORK)
EWR - NEWARK LIBERTY INTERNATIONAL AIRPORT (NEWARK, NEW JERSEY)
BWI - BALTIMORE/WASHINGTON INTERNATIONAL THURGOOD MARSHALL AIRPORT (BALTIMORE, MARYLAND)
FLL - FORT LAUDERDALE-HOLLYWOOD INTERNATIONAL AIRPORT (FORT LAUDERDALE, FLORIDA)
DCA - RONALD REAGAN WASHINGTON NATIONAL AIRPORT (WASHINGTON, D.C.)
SAN - SAN DIEGO INTERNATIONAL AIRPORT (SAN DIEGO, CALIFORNIA)
IAD - WASHINGTON DULLES INTERNATIONAL AIRPORT (WASHINGTON, D.C.)
HOU - WILLIAM P. HOBBY AIRPORT (HOUSTON, TEXAS)
TPA - TAMPA INTERNATIONAL AIRPORT (TAMPA, FLORIDA)
STL - LAMBERT-ST. LOUIS INTERNATIONAL AIRPORT (ST. LOUIS, MISSOURI)
BNA - NASHVILLE INTERNATIONAL AIRPORT (NASHVILLE, TENNESSEE)
AUS - AUSTIN-BERGSTROM INTERNATIONAL AIRPORT (AUSTIN, TEXAS)
MSY - LOUIS ARMSTRONG NEW ORLEANS INTERNATIONAL AIRPORT (NEW ORLEANS, LOUISIANA)
PDX - PORTLAND INTERNATIONAL AIRPORT (PORTLAND, OREGON)
OAK - OAKLAND INTERNATIONAL AIRPORT (OAKLAND, CALIFORNIA)
SMF - SACRAMENTO INTERNATIONAL AIRPORT (SACRAMENTO, CALIFORNIA)
SAT - SAN ANTONIO INTERNATIONAL AIRPORT (SAN ANTONIO, TEXAS)
RDU - RALEIGH-DURHAM INTERNATIONAL AIRPORT (RALEIGH-DURHAM, NORTH CAROLINA)
IND - INDIANAPOLIS INTERNATIONAL AIRPORT (INDIANAPOLIS, INDIANA)
CLE - CLEVELAND HOPKINS INTERNATIONAL AIRPORT (CLEVELAND, OHIO)
PIT - PITTSBURGH INTERNATIONAL AIRPORT (PITTSBURGH, PENNSYLVANIA)
SJC - NORMAN Y. MINETA SAN JOSE INTERNATIONAL AIRPORT (SAN JOSE, CALIFORNIA)
JAX - JACKSONVILLE INTERNATIONAL AIRPORT (JACKSONVILLE, FLORIDA)
MCI - KANSAS CITY INTERNATIONAL AIRPORT (KANSAS CITY, MISSOURI)
TUL - TULSA INTERNATIONAL AIRPORT (TULSA, OKLAHOMA)
OKC - WILL ROGERS WORLD AIRPORT (OKLAHOMA CITY, OKLAHOMA)
BHM - BIRMINGHAM-SHUTTLESWORTH INTERNATIONAL AIRPORT (BIRMINGHAM, ALABAMA)
BUF - BUFFALO NIAGARA INTERNATIONAL AIRPORT (BUFFALO, NEW YORK)
OGG - KAHULUI AIRPORT (KAHULUI, HAWAII)
MEM - MEMPHIS INTERNATIONAL AIRPORT (MEMPHIS, TENNESSEE)
PBI - PALM BEACH INTERNATIONAL AIRPORT (WEST PALM BEACH, FLORIDA)
ABE - LEHIGH VALLEY INTERNATIONAL AIRPORT (ALLENTOWN, PENNSYLVANIA)
ANC - TED STEVENS ANCHORAGE INTERNATIONAL AIRPORT (ANCHORAGE, ALASKA)
RSW - SOUTHWEST FLORIDA INTERNATIONAL AIRPORT (FORT MYERS, FLORIDA)
SNA - JOHN WAYNE AIRPORT (ORANGE COUNTY, CALIFORNIA)
SDF - LOUISVILLE MUHAMMAD ALI INTERNATIONAL AIRPORT (LOUISVILLE, KENTUCKY)
GSP - GREENVILLE-SPARTANBURG INTERNATIONAL AIRPORT (GREENVILLE, SOUTH CAROLINA)
TYS - MCGHEE TYSON AIRPORT (KNOXVILLE, TENNESSEE)
HSV - HUNTSVILLE INTERNATIONAL AIRPORT (HUNTSVILLE, ALABAMA)
BTV - BURLINGTON INTERNATIONAL AIRPORT (BURLINGTON, VERMONT)
GEG - SPOKANE INTERNATIONAL AIRPORT (SPOKANE, WASHINGTON)
RIC - RICHMOND INTERNATIONAL AIRPORT (RICHMOND, VIRGINIA)
TUS - TUCSON INTERNATIONAL AIRPORT (TUCSON, ARIZONA)
BZN - BOZEMAN YELLOWSTONE INTERNATIONAL AIRPORT (BOZEMAN, MONTANA)
ORF - NORFOLK INTERNATIONAL AIRPORT (NORFOLK, VIRGINIA)
DAY - DAYTON INTERNATIONAL AIRPORT (DAYTON, OHIO)
PWM - PORTLAND INTERNATIONAL JETPORT (PORTLAND, MAINE)
SAV - SAVANNAH/HILTON HEAD INTERNATIONAL AIRPORT (SAVANNAH, GEORGIA)
LIT - BILL AND HILLARY CLINTON NATIONAL AIRPORT (LITTLE ROCK, ARKANSAS)
GSO - PIEDMONT TRIAD INTERNATIONAL AIRPORT (GREENSBORO, NORTH CAROLINA)
FAT - FRESNO YOSEMITE INTERNATIONAL AIRPORT (FRESNO, CALIFORNIA)
GRR - GERALD R. FORD INTERNATIONAL AIRPORT (GRAND RAPIDS, MICHIGAN)
SYR - SYRACUSE HANCOCK INTERNATIONAL AIRPORT (SYRACUSE, NEW YORK)
MHT - MANCHESTER-BOSTON REGIONAL AIRPORT (MANCHESTER, NEW HAMPSHIRE)
CHS - CHARLESTON INTERNATIONAL AIRPORT (CHARLESTON, SOUTH CAROLINA)
CRP - CORPUS CHRISTI INTERNATIONAL AIRPORT (CORPUS CHRISTI, TEXAS)
AVL - ASHEVILLE REGIONAL AIRPORT (ASHEVILLE, NORTH CAROLINA)
ROA - ROANOKE-BLACKSBURG REGIONAL AIRPORT (ROANOKE, VIRGINIA)
ICT - WICHITA DWIGHT D. EISENHOWER NATIONAL AIRPORT (WICHITA, KANSAS)
RNO - RENO-TAHOE INTERNATIONAL AIRPORT (RENO, NEVADA)
LBB - LUBBOCK PRESTON SMITH INTERNATIONAL AIRPORT (LUBBOCK, TEXAS)
AGS - AUGUSTA REGIONAL AIRPORT (AUGUSTA, GEORGIA)
MOB - MOBILE REGIONAL AIRPORT (MOBILE, ALABAMA)
COS - COLORADO SPRINGS AIRPORT (COLORADO SPRINGS, COLORADO)
MFE - MCALLEN INTERNATIONAL AIRPORT (MCALLEN, TEXAS)
CID - THE EASTERN IOWA AIRPORT (CEDAR RAPIDS, IOWA)
LSE - LA CROSSE REGIONAL AIRPORT (LA CROSSE, WISCONSIN)
BFL - MEADOWS FIELD AIRPORT (BAKERSFIELD, CALIFORNIA)
SBN - SOUTH BEND INTERNATIONAL AIRPORT (SOUTH BEND, INDIANA)
TOL - TOLEDO EXPRESS AIRPORT (TOLEDO, OHIO)
LFT - LAFAYETTE REGIONAL AIRPORT (LAFAYETTE, LOUISIANA)
JAN - JACKSON-MEDGAR WILEY EVERS INTERNATIONAL AIRPORT (JACKSON, MISSISSIPPI)
PIA - GENERAL WAYNE A. DOWNING PEORIA INTERNATIONAL AIRPORT (PEORIA, ILLINOIS)
EVV - EVANSVILLE REGIONAL AIRPORT (EVANSVILLE, INDIANA)
GPT - GULFPORT-BILOXI INTERNATIONAL AIRPORT (GULFPORT, MISSISSIPPI)
FSM - FORT SMITH REGIONAL AIRPORT (FORT SMITH, ARKANSAS)
BTR - BATON ROUGE METROPOLITAN AIRPORT (BATON ROUGE, LOUISIANA)
TLH - TALLAHASSEE INTERNATIONAL AIRPORT (TALLAHASSEE, FLORIDA)
